G______X
___XXX__
X______X
__XXXX__
___X____
_____X__
XXX_____
_____XS_