____G__X
___XXX__
X______X
__XXXX__
___X__S_
_____X__