____G__X
___XXX__
X______X
____XXXX
___X__S_
____X___