____G__X
___XXX__
X______X
____XXXX
___X____
____X___